111111111111111111111111111111111111111111
1P00000000010000000100100000101000000000C1
100111101111110011110010011110111111111001
10C1001010000000100100C0010000100100101001
111100101001110010010011111110100100101001
1000C000001001000000000C0000100001C0001001
111100101010011111110010010010111111101001
100000101000000010000010010000000000100001
111100111C0111111001111111111110010C101001
100000001001010010000000000010000100001001
100111101111010C10011110011111111111111111
100100000000010000010C000000000000000000E1
111111111111111111111111111111111111111111