111111111111111111111111
10C0000C00000C0000000011
11000C0000C00000C0000011
11C00000P000C000000C0011
11000C00000C000000000011
11C0000C00000000C0000011
11000CE00000C0000000C011
10C000000C00000C00000011
111111111111111111111111